{
  "tileWidth": "50",
  "tileHeight": "50",
  "map1": {
      "path": [
        {"x": 0, "y": 100 },
        {"x": 150, "y": 100 },
        {"x": 150, "y": 400 },
        {"x": 600, "y": 400 },
        {"x": 600, "y": 100 },
        {"x": 300, "y": 100 },
        {"x": 300, "y": 650 },
        {"x": 700, "y": 650 }
      ],
      "tiles": [
      0, 0, 0, 0, 0, 0, 0, 0, 0, 0, 0, 0, 0, 0, 0, 0,
      0, 0, 0, 0, 0, 0, 0, 0, 0, 0, 0, 0, 0, 0, 0, 0,
      8, 1, 1, 2, 0, 0, 2, 1, 1, 1, 1, 1, 5, 0, 0, 0,
      0, 0, 0, 6, 0, 0, 6, 0, 0, 0, 0, 0, 6, 0, 0, 0,
      0, 0, 0, 6, 0, 0, 6, 0, 0, 0, 0, 0, 6, 0, 0, 0,
      0, 0, 0, 6, 0, 0, 6, 0, 0, 0, 0, 0, 6, 0, 0, 0,
      0, 0, 0, 6, 0, 0, 6, 0, 0, 0, 0, 0, 6, 0, 0, 0,
      0, 0, 0, 6, 0, 0, 6, 0, 0, 0, 0, 0, 6, 0, 0, 0,
      0, 0, 0, 3, 1, 1, 6, 1, 1, 1, 1, 1, 4, 0, 0, 0,
      0, 0, 0, 0, 0, 0, 6, 0, 0, 0, 0, 0, 0, 0, 0, 0,
      0, 0, 0, 0, 0, 0, 6, 0, 0, 0, 0, 0, 0, 0, 0, 0,
      0, 0, 0, 0, 0, 0, 6, 0, 0, 0, 0, 0, 0, 0, 0, 0,
      0, 0, 0, 0, 0, 0, 6, 0, 0, 0, 0, 0, 0, 0, 0, 0,
      0, 0, 0, 0, 0, 0, 3, 1, 1, 1, 1, 1, 1, 1, 9, 0,
      0, 0, 0, 0, 0, 0, 0, 0, 0, 0, 0, 0, 0, 0, 0, 0,
      0, 0, 0, 0, 0, 0, 0, 0, 0, 0, 0, 0, 0, 0, 0, 0
    ]
  }
}
